1111111111111
10010000000C1
10P011111E001
1000001110001
1111111111111