111111111111111
1E0000000000001
1010010C1010111
1P0000000C00C01
111111111111111