111111111111111
1E0000010000001
1010010C1010111
100000010C00C01
111111111111111